Hulk
- gào: Tanker_Roar
- Nhảnh đến nơi vả: Tanker_Die_Bodyfall
- tiếng bước chân: Tanker_Footstep1
- end nhảy về: Tanker_Rock2
- nhặt đá: Tanker_ripuprock
- vỡ đá: Tanker_rock_hard

Thrower
-Nhảy tiếp đất: rocket_exp 1
-Chạy: Tanker_run
-Cho 2 tay móc đá lên(2 lần): HitHouse_3_baseraid
-attack ném đá(gừ.....ựa-> ném): Tanker_Attack2
-Đá nổi lên từng cục: HitHouse_3_baseraid

Crasher
-bước chân: Tanker_Footstep1
-Idle: Tanker_Breathe
-dơ gậy lleen đầu đập: Tanker_Attack1
-Khi gậy đập xuống tới: Tanker_Rock2
-attack xoay gậy: Tanker_Attack2
-đánh tới người: Tanker_rock
-Dead: Tanker_Die

Chainsaw
- bắt đầu spawn: chainsaw_startup
- Loop: chainsaw_idle
- scream: Chainsaw_Roar
- hit: Bomber_Take_Damage

Revenant
- đập đất nổi lửa: HitHouse_3_baseraid
- start Jump: boss_zom_revenant_flyingsfx
- end jump: SFX_Jumperlicker_Landing
- Scream: Licker_Roar

- lửa bắt đầu bay: Revenant_fireball
- lửa nổ: Fireball_Explosion

Ogre
- đi: Tanker_Footstep1
- scream: tanker_Roar

- nổ cái ném: Tanker_WeaknessExplode


Death nổ: Tanker_WeaknessExplode